...###
..##.#.####
.##..#.#..#
#.........#
#.#.@..#..#
###..###..#
..#..#....#
.##....#.##
.#..##..##
.#.....##
.#######