###########
#...#.....#
#.#####.@.#
#...#...###
##....#...#
#....###.##
###.......#
#....######
###.#######
#.........#
###########